17,-1,-1,-1,-1,-1,-1,-1,-1,17,-1,-1,-1,-1,-1
17,-1,-1,-1,-1,-1,-1,-1,-1,17,-1,-1,-1,-1,-1
17,-1,-1,-1,-1,-1,-1,-1,-1,17,-1,-1,-1,-1,-1
17,-1,17,17,-1,-1,17,17,-1,17,-1,68,69,70,71
17,-1,17,-1,17,17,-1,17,-1,17,-1,-1,-1,-1,-1
17,-1,17,-1,-1,-1,-1,17,-1,17,-1,-1,114,-1,-1
17,-1,-1,17,-1,-1,17,-1,-1,17,-1,-1,-1,-1,-1
17,-1,-1,-1,17,17,-1,-1,-1,17,182,183,70,71,-1
17,-1,-1,-1,-1,-1,-1,-1,-1,17,-1,-1,-1,-1,-1
17,-1,-1,-1,-1,-1,-1,-1,-1,17,-1,-1,-1,-1,-1
